XXXXXXXXXXXXXXXXXXXX
X###################
X#####   ###########
X#####   ###########
X#####   ###########
X###      ##########
X### # ## ##########
X#   # ## #####  ++#
X#               ++#
X##### ### # ##  ++#
X#####     #########
X###################
