####################
#                 ##
#O#               ##
###              ###
####             ###
####          ######
####            ####
##   # ## ###      #
##                 #
###    ### #       #
###          #######
####################
